##################################################
#...#..#.........................................#
#..E..#..........#...............................#
#..#.............................................#
#...............#................................#
#.........#....................#.................#
#................#...............#...............#
#....##..............................#...........#
#...........#...................#................#
#.........................................#......#
#.....#..........................................#
#..#..................................#..........#
#..............#.................................#
#....#...........................................#
##............................#..........#.......#
#...................................#............#
#...............................#................#
#....#...............................#...........#
#.............................................#..#
#..........#.....................................#
#..S....................#....................#...#
#...#........................................#...#
#...............#......#.........................#
#..................................#.............#
#................................................#
#.............#..................................#
#................................................#
#................................................#
#........#.......................................#
##################################################