##################################################
#................................................#
#................................................#
#....#...............#...........................#
##........#..............#.......................#
#..............#.....S...........................#
#................................................#
#................................................#
#..#.............................................#
#...........#....................................#
#................................................#
#..........#.....................................#
#......................#.........................#
#..........................#.....................#
#..........#.....................................#
#............#...................................#
#.....................#..........................#
#.......................#........................#
#................................................#
#................................................#
#................................................#
#................................................#
#.........#......................................#
#.#.......................#......................#
#.......##.......................................#
##...............................................#
##E...........#..................................#
#......#.........................................#
#...#............................................#
##################################################
